personality: persönlichkeit
disagree: nicht einverstanden sein
compromise: kompromiss
smart: schlau
nature: natur
logic: logik
body: körper
saying: Sprichwort
practic: training
judge: bewerten
cover: titelblatt
matter: von bedeutung sein
I don't care: ist mir egal
be in: in sein
be out: out sein
as long as: solange
call-in: call sendung
imanigation: fantasie
compete: konkurrieren
themselves: sich selbst
push onself: sich alles abverlangen
study: lernen
enjoy onself: spaß haben
waste: verschwendung
accept: akzeptieren
grade: note
make it: es schaffen
complain: beschweren
report card: zeugniss
loser: verlierer
be hard on sb: streng sein
relax: entspannen
laid-back: locker
bossy: herrisch
rich: reich
college: universität
all by onself: ganz allein
successful: erfolgreich 
stubborn: eigensinnig
make a desicion: eine entscheidung treffen
ambitious: ehrgeizig
pushy: aufdringlich
react: reagieren
in sb's shoes: an jemands stelle
criticize: kritisieren
push sb: jemanden drängen
motivate: motivieren
chance: chance
middle school: mittelschule
trainer: trainer
safety: sicherheit
bond: bindung
come easily to sb: jemanden leichtfallen
influence: einfluss
norman: normanne
pork: schweinefleisch
beef: rindfleisch
mix: mixen
future: zukünftig
rural: ländlich
responsebility: verantwortung
living: lebensweise
be grounded: hauserrest haben
taste: schmecken
hot: heiß
spectacular: spektakulär
pot: topf
tasty: lecker
dish: speise
vegetable: gemüse
seem: scheinen
certain: bestimmt
recipe: rezept
drive: fahren
push sth right: etwas richtig stellen
understandabel: verständlich
dream: traum
extreme: extrem
comparable: vergleichbar
defeat: besiegen
meat: fleisch
remain: bleiben
greek: griechisch
have a point: nicht unrecht haben
meet halfway: einen komprimiss finden
I don't mind: ich habe nichts dagegen
this way: auf diese weise
misunderstood: missverstanden
ear: ohr
diving: tauchen
cage: käfig
strict: strikt
still: standbild
plate: teller
mug: becher
cup: tasse
spoon: löffel
knife: messer
fork: gabel
bread roll: brötchen
usage: gebraucht
what for: wofür