I'm from Greenwich:Ich bin aus Greenwich
look:schau/schaut mal
tow boys and a dog:zwei jungen und ein hund
in Greenwich park:im Greenwich-park
dogs are my friends,but not cats: hunde sind meine frunde, aber katzen nicht 
I'm a mouse.: ich bin eine maus 
mouse : maus
mice : mäuse
here's your ball: hier ist dein ball
hello:hallo
I'm pia : ich heiße pia
you're a nice dog : du bist ein lieber  hund
what's your name? : wie heißt du/sie
sorry : entschuldigung
my dog is crazy:mein hund ist verrückt
my name is luke: ich heiße luke
we're from Greenwich: wir sind aus Greenwich
whree are you from?:woher kommst du
are you on holiday?:sind sie im urlaub  
yes:jA
no : nein
I'm here with my parents : ich bin hier mit meinen eltern
how old are you :wie alt bist du
you too: ich auch
german: deutsch 
different: unterschiedlich
I'm englisch : ich bin engländerin
i love dogs: ich liebe hunde 
dogs love squirrels: hunde lieben eichhörnchen
that was close! : das war knapp!
animal : tier 
thank you : danke 
this is pia : das is pia
a girl from germany : ein mädchen aus deutschland 
school : schule
greenwich park is big : der greenwich-park ist groß
it's great for cycling : er ist super um radfahren
i don't like cycling: ich fahre nicht gern rad 
my favourite sport is football : mein lieblingssport ist fußball 
i like the boating lake : ich ,ag den see mit den booten 
what's that : was ist das 
let's go : los 
it's fun : es macht spaß
puzzle : rätsel
rat : ratte 
i'm not scared of dogs : ich habe keine angst vor hunden 
i'm scared of cats: ich habe angst vor katzen 
worms are ok : würmer sind ok 
rabbits are nice : kaninchen sind nett
they're my friends : sie sind meine freunde
they don't eat mice : sie essen keine mäuse 
word : wort 
hamster : hamster 
horse  :  pferd 
cat : katze 
worm : wurm 
parrot : papagei 
bear : bär 
rabbit : kaninchen 
dog : hund 
budgie : vogel 
fish : fisch 
squirrel : eichhörnchen
inline skating is great : inlineskaesfahrn ist toll
volleyball is a great sport : volleyball ist ein toller sport
the same : das gleiche    
colour : farbe 
correct : korrekt 
what's your favourite colour? : was ist deine lieblingsfarbe ?
picture : bild 
people : menschen 
thing : ding 
number : nummer 
boat number eight is pink : boot nummer acht ist rosa
i can see sherlock : ich kann sherlock sehen 
roll two  dice : würfle mit zwei würftl 
four and six is ten : vier plus sechs ist zehen 
please : bitte
can you name four sports? : kannst du vier sportarten nennen?
say your phone number : sage deine telefonnummer 
what colour is sherlock? : welche farbe hat sherlock
alphpahbet: alphabet 
rap like me : rappe wie ich 

