mirror : spiegel 
embarrassing : peinlich
to end up : enden
yearbook : jahrbuch
lol : lol
real : echt
show-of : angeber
art : kunst
what a.. : was für ein 
home town : heimstadt 
likes : vorlieben
dislikes : abneigungen
huge : riesig
field : feld 
hill : berg
outdoors : draußen 
mall : einkaufszentrum
eagel : adler 
feeling : gefühl
embarrassed : verlegen
nervous : nervös
proud of : stolz auf 
report : bericht
during während
actually : tatsächlich
barrel : fass
race : wettlauf
daughter
wheelchair : rollstuhl
to teach : unterrichten 
to tease sb : jmdn. aufziehen
latest : neueste
movie : film
movie theater : kino 
bird : vogel
air : luft
a bit : ein bisschen 
worried : besorgt 
to move (house) : umziehen 
to worry : sich sorgen machen 
plan : plan 
life : leben 
to have to : müssen 
to tell : erkennen
to point : zeigen 
bench : bank 
to grow up : aufwachsen 
youth : jugened 
close : nahe 
almost : fast
judge : richter
point : punkt
second : sekunde 
turn : wendung 
poor : arm
to get : werden
to fall off : herunterfallen 
mad : verückt 
what a shame : wie schade 
to train trainieren
to fix : repaieren 
positive : positiv 
negative : negativ
up : hinauf 
watch : armbanduhr
to be interested : interessiert sein an
i see : ich verstehe 
i mean : ich meine 
both : beide 
electronic : elektronisch
