off to : auf nach 
mountain range : bergkette
moose : elch 
kilometer : kilometer
peak : spitze
explorer : entdecker
wilderness : wildnis
to hike : wandern 
anyone eles : jemand anderes
wild off to : auf nach 
mountain range : bergkette
moose : elch 
kilometer : kilometer
peak : spitze
explorer : entdecker
bighorn sheep : dickhornschaf 
luck : glück 
couger : puma 
the great outdoor : die freie natur 
adventure : abenteuer 
climbing : klettern
challange ::  herausforderung
teen : teenager 
backpacking wandern 
to follow : folgen 
trail : weg 
to look out for: ausschau halten nach 
nearly : fast 
mountainboarding : mountainboardfahren
zipline : traditionell
campfire : lagerfeuer
to look forward to : sich freuen auf 
kid : jugendlicher
log cabin : blockhütte 
call phone : mobiltelefon
to hang on : einen augenblick warten 
it took ages : es dauert ewig
age : alter 
to go on : geschen 
trampoline : trampolin
to grin : grinsen 
platform : platform
canoe : kanu
to turn : drehen 
to turn over : umdrehen
wet : nass
difficult: schwierig
porcupine : baumstachler
noise : lärm 
else : sonst noch 
directly : direkt
to zipline : mit der seilrutsche fahren 
corner : ecke 
travel : reise
to spend : verbringen
hike : wanderung
to shine : scheinen
shhh : psst
side : seite
canyone : schlucht 
golden : golden 
to hold your breath : den atem anhalten 
along : entlang 
coyote : kojote
so that : jeder 
everybody : jeder 
to include : einschließen
