spiegel : mirror
peinlich : embarrassing
enden : to end up
jahrbuch : yearbook
lol : lol
echt : real
angeber : show-off
kunst : art
was für ein : what a..
heimstadt : home town
vorlieben : likes
abneigungen : dislikes
riesig : huge
feld : field
berg : hill
draußen : outdoors
einkaufszentrum : mall
adler : eagle
gefühl : feeling
verlegen : embarrassed
nervös : nervous
stolz auf : proud of
bericht : report
während : during
tatsächlich : actually
fass : barrel
wettlauf : race
tochter : daughter
rollstuhl : wheelchair
unterrichten : to teach
jmdn. aufziehen : to tease sb
neueste : latest
film : movie
kino : movie theater
vogel : bird
luft : air
ein bisschen : a bit
besorgt : worried
umziehen : to move (house)
sich sorgen machen : to worry
plan : plan
leben : life
müssen : to have to
erkennen : to tell
zeigen : to point
bank : bench
aufwachsen : to grow up
jugend : youth
nahe : close
fast : almost
richter : judge
punkt : point
sekunde : second
wendung : turn
arm : poor
werden : to get
herunterfallen : to fall off
verückt : mad
wie schade : what a shame
trainieren : to train
repaieren : to fix
positiv : positive
negativ : negative
hinauf : up
armbanduhr : watch
interessiert sein an : to be interested
ich verstehe : i see
ich meine : i mean
beide : both
elektronisch : electronic
auf nach : off to
bergkette : mountain range
elch : moose
kilometer : kilometer
spitze : peak
entdecker : explorer
wildnis : wilderness
wandern : to hike
jemand anderes : anyone else
auf nach : wild off to
bergkette : mountain range
elch : moose
kilometer : kilometer
spitze : peak
entdecker : explorer
dickhornschaf : bighorn sheep
glück : luck
puma : cougar
die freie natur : the great outdoors
abenteuer : adventure
klettern : climbing
herausforderung : challenge
teenager : teen
wandern : backpacking
folgen : to follow
weg : trail
ausschau halten nach : to look out for
fast : nearly
mountainboardfahren : mountainboarding
traditionell : zipline
lagerfeuer : campfire
sich freuen auf : to look forward to
jugendlicher : kid
blockhütte : log cabin
mobiltelefon : call phone
einen augenblick warten : to hang on
es dauert ewig : it took ages
alter : age
geschen : to go on
trampolin : trampoline
grinsen : to grin
platform : platform
kanu : canoe
drehen : to turn
umdrehen : to turn over
nass : wet
schwierig : difficult
baumstachler : porcupine
lärm : noise
sonst noch : else
direkt : directly
mit der seilrutsche fahren : to zipline
ecke : corner
reise : travel
verbringen : to spend
wanderung : hike
scheinen : to shine
seite : side
schlucht : canyon
golden : golden
den atem anhalten : to hold your breath
entlang : along
kojote : coyote
so dass : so that
jeder : everybody
einschließen : to include
wollte : wanted
wissen : to know
sprach : talked
fragte : asked
sicher : sure
antwortete : replied
ich würde es lieben : i'd love
melden : report
sah : saw
hinzugefügt : added
während : while
grinsen : grinning
flog : flew
zeigte : pointed
klang : sounded
lachte : laughed
antwortete : answered
raten : guess
dachte : thought
hörte : heard
gegenteil : opposite
erneut spielen : to replay   
sauber : tidy 
ausprobieren : to try on 
umkleidekabine : fitting room 
passen : to fit 
perfekt : perfectly 
socken : sock
verkäufer : assiant
stiefel :  boot 
hosen : pants
ärmel :  sleeve 
insekt : insect 
beißen : to bite 
tragen : to carry
sonnencreme : sunscreme
regen : rain
jacke : jacket
wanderer : hiker
aufheben : to pick up
müll : trash
boden : ground 
richen : to smell
berühren : to touch 
sicher : safe 
