krankenzimmer : l'infirmerie
eine klasse : une classe
ein Klassenzimmer : une salle de classe
pausenhof : la cour
unterricht : le cours
mediathek : le cdi
turnhalle : le gymnase
schwimmbad : la piscine
heute : aujourd'hui
wann : quand
wann kommst du nach hause: tu rentres à quelle heure 
was essen wir heute: on mange quand aujourd'hui
wer ist zu spät : qui est en retard
bei : chez
nach : aprés
sein : être
haben : avoir
guten tag : bonjour
also : alors
oder : ou
wie alt bist du :  tu as quel âge
wann hast du geburtstag : ton anniversaire c'est quand
hast du geschwister :  tu as des frères et soeurs
ein schlüssel : une clé
montag : lundi
gehen : aller
nicht : ne...pas
eine klasse 6a : la 6eA 
eine minute : une minute 
ein lehrer : un professur 
eine lehrerin :  professure 
unter : sous 
wenn : quand 
hallo : salut
entschuldigen sie : excusez-moi 
ein platz : une place
die hand : le main
die pause : une récréation
jemanden treffen : retrouver 
in der 6a : en 6eA 
etwas erzählen : raconter 
wem gehört er : il est à qui
ich weiß nicht : je ne sais pas 
das sind nicht meine sachen : ce ne sont pas mes affaire  
diskutieren : discuter 
willkommen : bienvenue
guten tag : bonjour
hallo : salut
wie geht's : ca va
ja : oui 
danke : merci 
tchüs : salut 
bis später : a plus
gut : bien 
auf wiedersehen : au revoir
ein freund : un ami
eine freundin : une amie
ich heiße : je m´appelle
und : et
du : toi
ich : moi
komm : viens
schnell : vite
papa : papa
paris : paris
wer ist das : qui est-ce
achtung : attention
nein : non
entschuldigen : pardon
wie : comment
wie heißt du : tu t'appelles comment 
das ist : c'est