g day : guten tag 
coral reef : korallenriff
purpose : ziel 
basicilly : grundsätzlich
climatic : klimatisch
virtually : praltisch
uninhabitable : unbewohnbar
enormous :enorm 
debt : schuld
per capita : pro kopf
poverty : Armut 
currently : momentan
unique : einzigartig
outstanding : außergewöhnlich
exploitation : ausbeutung
harmfull : schädlich 
account for : ausmachen
gleam : glänzen
cluster : bündel
seashell : muschel
the day after tomorrow : übermorgen
overhear : belauschen
terrace : terrasse
bloke : typ
air ambulance : rettungshubschrauber
satellite : satellit 
cancel : absagen
hopefully : hoffentlich 
sting : stechen
box jellyfish : würfelqualle
