Persönlichkeit : personality
Nicht einverstanden sein : disagree
Kompromiss : compromise
Schlau : smart
Natur : nature
Logik : logic
Körper : body
Sprichwort : saying
Training : practic
Bewerten : judge
Titelblatt : cover
Von Bedeutung sein : matter
Ist mir egal : I don't care
In sein : be in
Out sein : be out
Solange : as long as
Call Sendung : call-in
Fantasie : imagination
Konkurrieren : compete
Sich selbst : themselves
Sich alles abverlangen : push oneself
Lernen : study
Spaß haben : enjoy oneself
Verschwendung : waste
Akzeptieren : accept
Note : grade
Es schaffen : make it
Beschweren : complain
Zeugnis : report card
Verlierer : loser
Streng sein : be hard on sb
Entspannen : relax
Locker : laid-back
Herrisch : bossy
Reich : rich
Universität : college
Ganz allein : all by oneself
Erfolgreich : successful
Eigensinnig : stubborn
Eine Entscheidung treffen : make a decision
Ehrgeizig : ambitious
Aufdringlich : pushy
Reagieren : react
An jemandes Stelle : in sb's shoes
Kritisieren : criticize
Jemanden drängen : push sb
Motivieren : motivate
Chance : chance
Mittelschule : middle school
Trainer : trainer
Sicherheit : safety
Bindung : bond
Jemandem leichtfallen : come easily to sb
Einfluss : influence
Normanne : norman
Schweinefleisch : pork
Rindfleisch : beef
Mixen : mix
Zukünftig : future
Ländlich : rural
Verantwortung : responsibility
Lebensweise : living
Hauserrest haben : be grounded
Schmecken : taste
Heiß : hot
Spektakulär : spectacular
Topf : pot
Lecker : tasty
Speise : dish
Gemüse : vegetable
Scheinen : seem
Bestimmt : certain
Rezept : recipe
Fahren : drive
Etwas richtig stellen : push sth right
Verständlich : understandable
Traum : dream
Extrem : extreme
Vergleichbar : comparable
Besiegen : defeat
Fleisch : meat
Bleiben : remain
Griechisch : greek
Nicht unrecht haben : have a point
Einen Kompromiss finden : meet halfway
Ich habe nichts dagegen : I don't mind
Auf diese Weise : this way
Missverstanden : misunderstood
Ohr : ear
Tauchen : diving
Käfig : cage
Strikt : strict
Standbild : still
Teller : plate
Becher : mug
Tasse : cup
Löffel : spoon
Messer : knife
Gabel : fork
Brötchen : bread roll
Gebraucht : usage
Wofür : what fors