to step: treten
to hold on: durchhalten
weak: schwach
headband: stirnband
flash flood: sturzflut
thunderstorm: gewitter
glad: froh
out of breath: außer atem
raindrop: regentropfen
a while: eine weile
to scratch: kratzen
fill up: füllen
off: herunter
to treat: behandeln
soft: weich
opening: öffnung
narrow: eng
to shop: einkaufen
to publish: veröffentlichen
guidebook: reiseführer
arrival: ankunft
therefore: deshalb
independence: unabhängigkeit
disease: umstritten
anniversary: jubiläum
fascinate: faszinieren
to take revenge: rache nehmen
contradict: widersprechen
to accuse: beschuldigen
threaten: drohen
quite: völlig
law: gesetz
onion: zwiebel
flavor: aroma
focus: fokus
sacred: heilig
traffic: verkehr
aussprache riesenkaktus: suaror
schreibweise riesenkaktus: saguaro
air-conditioning: klimaanlage
likely: wahrscheinlich
scholarship: stipendium
graduate: schulabschluss
settlement: siedlung
to be inhabited: bewohnt sein
wide-open: weit und flach
site: lage
