deal: abmachung
It´s my treat: Das geht auf meine Rechnung
waiter: kellner
to be in a hurry: in Eile sein
kind of: ziemlich
means of transport: transportmittel
my kind of: nach meinem geschmack
totally: total
the other day: neulich
down:unten
canadia: kanadier
driver´s license: führerschein
calm: ruhe
reflection: spiegelung
spot: entdecken
killjoy: spielverderber
you got no soul: du hast kein mitgefühl
waterfront: ufer
disadvantage: nachteil
economy: wirtschaft
retail: einzelhandel
employee: angestellter
total: gesamt
growth: wachstum
volcano: vulkan
whale: wal
orca: schwertwal
boomtown: boomtown
population: bevölkerung
argue: argumentieren
open to: führen zu
balcony: balkon
staircase: treppenhaus
simple: einfach
guest: gast
issue: angelegenheit
preference: vorliebe
obey: gehorchen
allowance: taschengeld
carpet: teppich
rug: vorleger
dishwasher: spülmaschine
empty: leeren
load: laden
vacuum: staubsaugen
dishes: geschirr
do the dishes: den abwasch machen
chore: pflicht
household: haushalt
recently: kürzlich
badly-written
special effect: spezialeffekt
excellent: exzellent
emotion: emotion
performance: leistung