die gemeinsamkeit: l´ensamble
täglich: quotidien
ein fehrnsehsender: une chain de télévision
eine landschaft: un paysage
absolut: absolu
dazugehören: faire partie
die médien: les medias
fließend: courant
im laufe: au cours de
ein drittel: un tiers
städtepartnerschaft: etre jumelé avec
gewiss: certain
das eis: la glace
ein see: un lac
eine wanderung: une randonnée
ein schlitten: un traineau
ein quadratkilometer: un kilonetre carre
ein wal: une baleine
angeln: pecher
sterben: mourir
unterirdisch: souterrain
herstellen: fabriquer
zählen: compter
ureinwohner: autochton
gründen: fonder
ein eisbär: un ours polaire
ein treffen: une rancontre
der hohe norden: le grand nord
der schnee: la neige
ein sturm: une tempete
darstellen: représenter
sich entfernen: s´éloigner
der langlauf: le ski de fond
etw. verbessern: améliorer
sich nähern: s´approcher
reagieren: réagir
berhigen: calmer
vorsichtig: prudent
benachrechtigen: avertir
ein jäger: un chasseur
auf die suche: partir a la recherche
die nahrung: la nourriture
jedenfalls: en tout cas
ein verhalten: un comportement
jagen: chasser