ablegen: passer
obligatorisch: obliegatorie
ebbe flut: marees
genau: exactement
gefahr: danger
schild: panneau
bucht: baie
touristisch: touristique
abend: soiree
infusion: perfusion
kräuter: herbes
tee: the
kräutertee: infusion
reisetagebuch: carnet de voyage
notizbuch: carnet
nett: gentill
abtei: abbaye
böse: mechant
dämlich: debile
vermeiden: eviter
verlegen: gene
sorge: souci
libérer: befreien  
l’occupation nazie: Nazibesatzung  
un bloc de béton: Betonblock
Alliés: Alliierten  
diriger: lenken
s’entraîner: trainieren  
roue: Rad  
blesser: verletzen  
bouger : bewegen  
les urgences: die Notaufnahme  
un médecin: ein Arzt
une foulure: eine Verstauchung  
un patient: ein Patient
prendre rendez-vous: einen Termin vereinbaren  
docteur: Doktor 
urgent: dringend  
gorge: Hals
fièvre: Fieber  
il vous faut: Sie brauchen
ordonnance: ein Rezept
maladie: Krankheit  
assurance maladie: eine Krankenversicherung  
pharmacie: Apotheke  
rembourser: zurückerstatten  
revoir: wiedersehen
